12
6
7
#######
###X  #
#E#   #
#  C#C#
#   #X#
#######