30
6
11
###########
#    X  ### 
#E      ###
#  C#C# ###
#        X#
###########
