20
10
7
#######
###X  #
#E#   #
#  C#C#
#   #X#
##C####
#     #
#   X##
#    ##
#######
